10
-.G.-.B.P.B.-.-.G.-
-.G.S.B.P.B.-.-.G.-
-.BS.W.BS.P.B.-.-.-.-
B.P.BS.-.B.-.-.G.-.-
P.B.-.-.-.-.-.-.G.-
B.-.S.-.-.-.B.-.-.-
-.S.W.S.-.B.P.B.-.-
-.-.S.B.-.-.B.G.B.-
-.G.B.P.B.-.-.B.P.B
-.G.-.B.-.-.-.-.B.-