10
-.G.-.G.B.G.-.-.G.-
-.G.S.B.P.B.-.-.-.-
-.BS.W.BS.P.B.-.-.-.-
B.P.BS.-.B.-.-.-.-.-
P.B.-.-.-.-.-.-.G.-
B.-.S.-.-.-.B.-.-.-
-.S.W.S.-.B.P.B.-.-
-.-.S.B.-.-.B.G.B.-
-.G.B.P.B.-.-.B.P.B
-.G.-.B.-.-.-.-.B.-